0,1,2,3,4,5,6,7
Tran Date,Value Date,Transaction Particulars,Chq No.,Amount,DR|CR,Balance,Branch Name
,,OPENING BALANCE :,,,,25184.55,
,,,,,,,ATM
03-12-2018,03-12-2018,EDC/00049-00051-/M037011032984700,,5053.95,CR,30238.50,RECONCILATION
,,,,,,,CENTRE
,,,,,,,ZAMROODPUR
06-12-2018,06-12-2018,ECOM PUR/PTM*PAYTM/NOIDA/061218/09:18,,7853.25,DR,22385.25,
,,,,,,,DEL DL
07-12-2018,07-12-2018,IMPS/P2A/834111246344/50100096080290HDFC0004108/,,12005.90,DR,10379.35,
07-12-2018,07-12-2018,UPI/P2A/834184872222/YBL5e634a07d3c24593ba2586b7,,1700.00,CR,12079.35,
14-12-2018,14-12-2018,ECOM PUR/One97 Communi/Noida/141218/12:02,,480.00,DR,11599.35,
15-12-2018,15-12-2018,GST @18% on Charge,,189.00,DR,11410.35,
15-12-2018,15-12-2018,Consolidated Charges for A/c,,1050.00,DR,10360.35,
18-12-2018,18-12-2018,ECOM PUR/PAYTM/1204770770/181218/12:17,,30.00,DR,10330.35,
19-12-2018,19-12-2018,IMPS/P2A/835314069033/50100096080290HDFC0004108/,,7505.90,DR,2824.45,
,,BY CASH DEPOSIT-,,,,,ZAMROODPUR
20-12-2018,20-12-2018,,,24000.00,CR,26824.45,
,,BNA/DPRH329801/1536/201218/SOUTH D,,,,,DEL DL
,,OPENING BALANCE :,,,,25184.55,
,,BY CASH DEPOSIT-,,,,,ZAMROODPUR
20-12-2018,20-12-2018,,,4900.00,CR,31724.45,
,,BNA/DPRH329801/1538/201218/SOUTH D,,,,,DEL DL
,,,,,,,MAHANAGAR
20-12-2018,20-12-2018,NEFT/MB/AXMB183547203664/RANJIT DUTTA,,7500.00,DR,24224.45,
,,,,,,,LUCKNOW
,,,,,,,CCGOI
20-12-2018,20-12-2018,By Clg 000277 485 DELHI,277,10000.00,CR,34224.45,HYDERABAD HYD
,,,,,,,TG
,,,,,,,ZAMROODPUR
24-12-2018,23-12-2018,POS/MANAV SNACKS/NEW DELHI/231218/19:49,,205.00,DR,34019.45,
,,,,,,,DEL DL
,,,,,,,ATM
24-12-2018,24-12-2018,EDC/00052-00052-/M037011032984700,,2521.74,CR,36541.19,RECONCILATION
,,,,,,,CENTRE
26-12-2018,26-12-2018,ECOM PUR/One97 Communi/Noida/261218/09:18,,4330.00,DR,32211.19,
26-12-2018,26-12-2018,POS/MANAV SNACKS/NEW DELHI/261218/13:54,,470.00,DR,31741.19,
26-12-2018,26-12-2018,ECOM PUR/PAYTM/Noida/261218/15:55,,881.00,DR,30860.19,
26-12-2018,26-12-2018,POS/MANAV SNACKS/NEW DELHI/261218/20:11,,180.00,DR,30680.19,
03-01-2019,03-01-2019,ECOM PUR/PAYTM/Noida/030119/17:55,,300.00,DR,30380.19,
04-01-2019,04-01-2019,,,10000.00,CR,40380.19,
,,BNA/DPRH329801/4310/040119/SOUTH D,,,,,DEL DL
09-01-2019,09-01-2019,,,4500.00,CR,44880.19,
,,BNA/DPRH329801/5215/090119/SOUTH D,,,,,DEL DL
11-01-2019,11-01-2019,UPI/P2A/901136972198/PTM25263dcde63546ba8c643d4c,,1.00,CR,44881.19,
,,,,,,,DATA CENTRE-
11-01-2019,11-01-2019,NEFT/SBIN319011812488/Mr RANJIT DUTTA//ATTN//INB,,3500.00,CR,48381.19,
,,,,,,,CHEMBUR
12-01-2019,12-01-2019,GST @18% on Charge,,9.00,DR,48372.19,
12-01-2019,12-01-2019,Consolidated Charges for A/c,,50.00,DR,48322.19,
,,,,,,,ATM
14-01-2019,14-01-2019,EDC/00053-00053-/M037011032984700,,1001.90,CR,49324.09,RECONCILATION
,,,,,,,CENTRE
,,,,,,,ZAMROODPUR
14-01-2019,14-01-2019,IMPS/P2A/901412924696/919971624523/INETIMPS00073,,497.00,CR,49821.09,
,,,,,,,DEL DL
14-01-2019,14-01-2019,IMPS/P2A/901412927199/919971624523/MOBUA01304940,,400.00,CR,50221.09,
14-01-2019,14-01-2019,IMPS/P2A/901412321960/0831010104411UTBI0MBZC45/,,50005.90,DR,215.19,
15-01-2019,15-01-2019,ECOM PUR/PAYTM/Noida/150119/10:25,,150.00,DR,65.19,
,,BY CASH DEPOSIT-,,,,,ZAMROODPUR
17-01-2019,17-01-2019,,,1000.00,CR,1065.19,
,,BNA/DPRH329801/6971/170119/SOUTH D,,,,,DEL DL
17-01-2019,17-01-2019,IMPS/P2A/901713217651/62246765390SBIN0001078/,,1002.95,DR,62.24,
21-01-2019,21-01-2019,EDC/00054-00054-/M037011032984700,,2403.49,CR,2465.73,RECONCILATION
22-01-2019,22-01-2019,EDC/00055-00055-/M037011032984700,,1426.82,CR,3892.55,RECONCILATION
22-01-2019,22-01-2019,ECOM PUR/PAYTM/1204770770/220119/13:26,,400.00,DR,3492.55,
23-01-2019,23-01-2019,,,24500.00,CR,27992.55,
,,BNA/DPRH329801/8113/230119/SOUTH D,,,,,DEL DL
23-01-2019,23-01-2019,,,500.00,CR,28492.55,
,,BNA/DPRH329801/8115/230119/SOUTH D,,,,,DEL DL
24-01-2019,24-01-2019,ECOM PUR/PTM*PAYTM/NOIDA/240119/17:50,,7000.00,DR,21492.55,
28-01-2019,28-01-2019,EDC/00056-00056-/M037011032984700,,1957.98,CR,23450.53,RECONCILATION
28-01-2019,28-01-2019,,,11500.00,CR,34950.53,
,,BNA/DPRH329801/8913/280119/SOUTH D,,,,,DEL DL
28-01-2019,28-01-2019,,,500.00,CR,35450.53,
,,BNA/DPRH329801/8915/280119/SOUTH D,,,,,DEL DL
28-01-2019,28-01-2019,MOB/SELFFT/RANJIT DUTTA/918010003842859,,1000.00,DR,34450.53,
28-01-2019,28-01-2019,MOB/SELFFT/RANJIT DUTTA/917010082670968,,20000.00,DR,14450.53,
29-01-2019,29-01-2019,EDC/00057-00057-/M037011032984700,,651.87,CR,15102.40,RECONCILATION
29-01-2019,29-01-2019,ECOM PUR/PAYTM/1204770770/290119/09:35,,100.00,DR,15002.40,
29-01-2019,29-01-2019,ECOM PUR/Amazon Seller/Bangalore/290119/15:18,,4130.00,DR,10872.40,
30-01-2019,30-01-2019,NEFT/MB/AXMB190300233679/CLARA TOPPO,,1.00,DR,10871.40,JAMSHEDPUR [JH]
30-01-2019,30-01-2019,By Clg 000094 240 DELHI,94,19000.00,CR,29871.40,CCGO NORTH MH
31-01-2019,31-01-2019,MOB/C34GPI054497/Airtel Delhi NCR Delhi NCR,,489.00,DR,29382.40,
04-02-2019,03-02-2019,ECOM PUR/PTM*PAYTM/NOIDA/030219/11:29,,91.00,DR,29291.40,
04-02-2019,04-02-2019,ECOM PUR/PAYTM/Noida/040219/12:18,,179.87,DR,29111.53,
07-02-2019,07-02-2019,UPI/P2A/903860182209/YBL2e42360feff34c59a1a2a800,,1160.00,CR,30271.53,
09-02-2019,09-02-2019,ATM-CASH/KAILASH COLONY/KALKAJI/090219,,2000.00,DR,28271.53,
11-02-2019,11-02-2019,EDC/00058-00058-/M037011032984700,,194.40,CR,28465.93,RECONCILATION
13-02-2019,13-02-2019,MOB/SELFFT/RANJIT DUTTA/917010082670968,,8166.00,DR,20299.93,
13-02-2019,13-02-2019,ATM-CASH/+BOB/NEW DELHI/130219,,500.00,DR,19799.93,
13-02-2019,13-02-2019,ATM-CASH/+SADDAR BAZAAR/DELHI/130219,,800.00,DR,18999.93,ZAMROODPUR
14-02-2019,14-02-2019,ECOM PUR/PAYTM/1204770770/140219/20:53,,203.00,DR,18796.93,
16-02-2019,16-02-2019,EDC/00059-00060-/M037011032984700,,10795.73,CR,29592.66,RECONCILATION
16-02-2019,16-02-2019,GST @18% on Charge,,9.00,DR,29583.66,
16-02-2019,16-02-2019,Consolidated Charges for A/c,,50.00,DR,29533.66,
19-02-2019,19-02-2019,ECOM PUR/ONE97 COMMUNI/NOIDA/190219/20:14,,250.00,DR,29283.66,
25-02-2019,25-02-2019,EDC/00061-00061-/M037011032984700,,1426.82,CR,30710.48,RECONCILATION
25-02-2019,25-02-2019,ECOM PUR/PTM*PAYTM/NOIDA/250219/11:37,,3880.00,DR,26830.48,
27-02-2019,27-02-2019,EDC/00062-00062-/M037011032984700,,1681.82,CR,28512.30,RECONCILATION
27-02-2019,27-02-2019,,,16000.00,CR,44512.30,
,,BNA/DPRH329801/5368/270219/SOUTH D,,,,,DEL DL
,,,,,,,GORABAZAR KOL
27-02-2019,27-02-2019,NEFT/MB/AXMB190589836488/CLARA TOPPO,,25000.00,DR,19512.30,
,,,,,,,WB
,,ATM-CASH/+KAILASH COLONY BR/SOUTH,,,,,ZAMROODPUR
27-02-2019,27-02-2019,,,500.00,DR,19012.30,
,,DELHI/270219,,,,,DEL DL
02-03-2019,02-03-2019,ECOM PUR/PAYTM/1204770770/020319/19:39,,40.00,DR,18972.30,
04-03-2019,04-03-2019,BRN-CLG-CHQ PAID TO ABHI WATER POINT,8191,420.00,DR,18552.30,CCGO NORTH MH
04-03-2019,04-03-2019,By Clg 000306 485 DELHI,306,10000.00,CR,28552.30,CCGO NORTH MH
07-03-2019,07-03-2019,ECOM PUR/PAYTM/1204770770/070319/18:13,,400.00,DR,28152.30,
08-03-2019,08-03-2019,MOB/SELFFT/RANJIT DUTTA/917010082670968,,8100.00,DR,20052.30,ZAMROODPUR
09-03-2019,09-03-2019,,,10000.00,DR,10052.30,
,,DELHI/090319,,,,,DEL DL
09-03-2019,09-03-2019,,,200.00,DR,9852.30,
09-03-2019,09-03-2019,MOB/SELFFT/RANJIT DUTTA/917010082670968,,1800.00,DR,8052.30,
13-03-2019,13-03-2019,By Clg 000459 240 DELHI,459,13860.00,CR,21912.30,CCGO NORTH MH
14-03-2019,14-03-2019,ECOM PUR/One97 Communi/Noida/140319/14:00,,300.00,DR,21612.30,
14-03-2019,14-03-2019,ECOM PUR/One97 Communi/Noida/140319/14:06,,100.00,DR,21512.30,
16-03-2019,16-03-2019,GST @18% on Charge,,23.40,DR,21488.90,
16-03-2019,16-03-2019,Consolidated Charges for A/c,,130.00,DR,21358.90,
22-04-2019,22-04-2019,BRN-CLG-CHQ PAID TO ABHIWATERPOINT,8193,1330.00,DR,15972.78,CCGO NORTH MH
,,,,,,,"DLF, GURGAON"
08-05-2019,08-05-2019,NEFT/MB/AXMB191285195349/RANJIT DUTTA,,3700.00,DR,12272.78,
,,,,,,,[HR]
11-05-2019,11-05-2019,GST @18% on Charge,,9.00,DR,12263.78,
11-05-2019,11-05-2019,Consolidated Charges for A/c,,50.00,DR,12213.78,
13-05-2019,13-05-2019,POS/TANEJA COMPLETE H/DELHI/130519/13:15,,308.00,DR,11905.78,
14-05-2019,14-05-2019,IMPS/P2A/913411213665/345701000003749IOBA0003457,,10005.90,DR,1899.88,
16-05-2019,16-05-2019,,,31000.00,CR,32899.88,
,,BNA/DPRH329801/9910/160519/SOUTH D,,,,,DEL DL
16-05-2019,16-05-2019,MOB/SELFFT/RANJIT DUTTA/917010082670968,,5000.00,DR,27899.88,
16-05-2019,16-05-2019,NEFT/MB/AXMB191368693695/RANJIT DUTTA,,10000.00,DR,17899.88,PALWANCHA TG
16-05-2019,16-05-2019,MOB/SELFFT/RANJIT DUTTA/918010003842859,,5000.00,DR,12899.88,
29-05-2019,29-05-2019,By Clg 000472 240 DELHI,472,8400.00,CR,21299.88,CCGO NORTH MH
06-06-2019,06-06-2019,IMPS/P2A/915710322610/50100096080290HDFC0004108/,,9005.90,DR,12293.98,
13-06-2019,13-06-2019,,,30000.00,CR,42293.98,
,,BNA/DPRH329801/4504/130619/SOUTH D,,,,,DEL DL
15-06-2019,15-06-2019,Consolidated Charges for A/c,,50.00,DR,41054.98,
21-06-2019,21-06-2019,ECOM PUR/Amazon Pay/8033420300/210619/14:53,,7.00,DR,41047.98,
22-06-2019,22-06-2019,POS/C R BLESSING SALO/DELHI/220619/11:34,,1.00,DR,41046.98,
23-06-2019,23-06-2019,POS/C R BLESSING SALO/DELHI/230619/19:06,,1.00,DR,41045.98,
24-06-2019,24-06-2019,EDC/00064-00064-/M037011032984700,,3009.82,CR,44055.80,RECONCILATION
25-06-2019,25-06-2019,ECOM PUR/PTM*PAYTM/NOIDA/250619/15:00,,32.30,DR,44023.50,
26-06-2019,26-06-2019,ECOM PUR/PTM*PAYTM/NOIDA/260619/18:01,,5200.00,DR,38823.50,
27-06-2019,27-06-2019,EDC/00065-00065-/M037011032984700,,1311.84,CR,40135.34,RECONCILATION
01-07-2019,02-07-2019,ECOM PUR/PAYTM/1204770770/010719/23:19,,157.00,DR,39978.34,
03-07-2019,03-07-2019,EDC/00066-00066-/M037011032984700,,15876.05,CR,55854.39,RECONCILATION
04-07-2019,04-07-2019,AXMOB/DTHR/E0GHJK2D9390/918020005864931/040719,,354.00,DR,55500.39,
05-07-2019,05-07-2019,MOB/SELFFT/RANJIT DUTTA/918010003842859,,5000.00,DR,50500.39,
05-07-2019,05-07-2019,MOB/SELFFT/RANJIT DUTTA/917010082670968,,5000.00,DR,45500.39,
,,,,,,,"VASTRAPUR,"
05-07-2019,05-07-2019,NEFT/MB/AXMB191864427147/RANJIT DUTTA,,6000.00,DR,39500.39,
,,,,,,,AHMEDABAD [GJ]
09-07-2019,09-07-2019,ECOM PUR/One97 Communi/Noida/090719/15:19,,1200.00,DR,38300.39,
09-07-2019,09-07-2019,ECOM PUR/ONE97 COMMUNI/NOIDA/090719/15:35,,200.00,DR,38100.39,ZAMROODPUR
09-07-2019,09-07-2019,POS/RWL HEALTHWORLD/NEW DELHI/090719/19:45,,192.00,DR,37908.39,
11-07-2019,11-07-2019,EDC/00067-00067-/M037011032984700,,4240.39,CR,42148.78,RECONCILATION
,,BRN-CLG-CHQ PAID TO CHURCH OF,,,,,
11-07-2019,11-07-2019,,8194,3000.00,DR,39148.78,CCGO NORTH MH
,,TRANSFIGURATION,,,,,
11-07-2019,11-07-2019,ECOM PUR/PTM*LIFE INSU/NOIDA/110719/13:40,,5616.14,DR,33532.64,
11-07-2019,11-07-2019,ECOM PUR/PTM*LIFE INSU/NOIDA/110719/13:44,,4278.86,DR,29253.78,
13-07-2019,13-07-2019,GST @18% on Charge,,9.00,DR,29244.78,
13-07-2019,13-07-2019,Consolidated Charges for A/c,,50.00,DR,29194.78,
,,,,,,,"LAJPAT NAGAR,"
16-07-2019,16-07-2019,NEFT/MB/AXMB191978623982/SOBAWATI,,5000.00,DR,24194.78,
,,,,,,,NEW DELHI [DL]
19-07-2019,19-07-2019,EDC/00068-00068-/M037011032984700,,34379.32,CR,58574.10,RECONCILATION
,,,,,,,"TALWANDI, KOTA"
19-07-2019,19-07-2019,NEFT/MB/AXMB192009631225/RANJIT DUTTA,,34000.00,DR,24574.10,
,,,,,,,KOA RJ
21-07-2019,21-07-2019,"POS/FUNCITY,/NOIDA/210719/19:00",,2000.00,DR,22574.10,
21-07-2019,21-07-2019,POS/DLF MALL OF INDIA/NOIDA/210719/19:50,,208.96,DR,22365.14,
24-07-2019,24-07-2019,ECOM PUR/PTM*PAYTM/NOIDA/240719/11:42,,6730.00,DR,15635.14,
25-07-2019,25-07-2019,POS/ASIAN CLINIC/NEW DELHI/250719/11:43,,178.00,DR,15457.14,
26-07-2019,26-07-2019,EDC/00069-00069-/M037011032984700,,34069.57,CR,49526.71,RECONCILATION
26-07-2019,26-07-2019,IMPS/P2A/920713897027/RANJIT/STATEBA/X035769/,,34010.90,DR,15515.81,
27-07-2019,27-07-2019,ECOM PUR/PAYTM/Noida/270719/14:42,,35.00,DR,15480.81,
27-07-2019,27-07-2019,ECOM PUR/PAYTM/Noida/270719/15:44,,35.00,DR,15445.81,
29-07-2019,29-07-2019,ECOM PUR/One97 Communi/Noida/290719/20:44,,359.99,DR,15085.82,
02-08-2019,02-08-2019,REFUND/PAYTM\B 121 SEC 5\NO/27-JUL-19,,35.00,CR,15120.82,RECONCILATION
03-08-2019,03-08-2019,EDC/00070-00070-/M037011032984700,,2137.56,CR,17258.38,RECONCILATION
05-08-2019,05-08-2019,NEFT/MB/AXMB192175347994/RANJIT DUTTA,,1900.00,DR,15358.38,
06-08-2019,06-08-2019,NEFT/MB/AXMB192185888487/RANJIT DUTTA,,100.00,DR,15258.38,
07-08-2019,07-08-2019,POS/TRESOR SALON PVT/DELHI/070819/12:28,,4590.00,DR,10668.38,
07-08-2019,07-08-2019,ECOM PUR/One97 Communi/Noida/070819/18:47,,836.40,DR,9831.98,
09-08-2019,09-08-2019,,,45000.00,CR,54831.98,
,,BNA/DPRH329801/4976/090819/SOUTH D,,,,,DEL DL
09-08-2019,09-08-2019,,,11500.00,CR,66331.98,
,,BNA/DPRH329801/4978/090819/SOUTH D,,,,,DEL DL
09-08-2019,09-08-2019,NEFT/MB/AXMB192217586534/RANJIT DUTTA,,40000.00,DR,26331.98,
09-08-2019,09-08-2019,ECOM PUR/PTM*PAYTM/NOIDA/090819/15:01,,1000.00,DR,25331.98,
10-08-2019,10-08-2019,IMPS/P2A/922215588180/RANJIT/STATEBA/X035769/,,1002.95,DR,24329.03,
10-08-2019,10-08-2019,GST @18% on Charge,,9.00,DR,24320.03,
10-08-2019,10-08-2019,Consolidated Charges for A/c,,50.00,DR,24270.03,
12-08-2019,12-08-2019,ECOM PUR/PTM*PAYTM/NOIDA/120819/12:03,,500.00,DR,23770.03,
13-08-2019,13-08-2019,NEFT/MB/AXMB192258016621/RANJIT DUTTA,,100.00,DR,23670.03,
13-08-2019,13-08-2019,NEFT/MB/AXMB192258208659/SOBAWATI,,4000.00,DR,19670.03,
13-08-2019,13-08-2019,By Clg 419899 234 DELHI,419899,4500.00,CR,24170.03,CCGO NORTH MH
14-08-2019,14-08-2019,ECOM PUR/PTM*PAYTM/NOIDA/140819/13:08,,1000.00,DR,23170.03,
14-08-2019,14-08-2019,ECOM PUR/PAY*ZOOMCAR I/GURGAON/140819/16:16,,5914.00,DR,17256.03,
15-08-2019,15-08-2019,ECOM PUR/Revv self dri/Gurgaon/150819/09:39,,6130.00,DR,11126.03,
15-08-2019,15-08-2019,POS/DLF MALL OF INDIA/NOIDA/150819/16:39,,491.40,DR,10634.63,
16-08-2019,16-08-2019,ECOM PUR/One97 Communi/Noida/160819/12:23,,49.00,DR,10585.63,
16-08-2019,16-08-2019,ECOM PUR/One97 Communi/Noida/160819/13:37,,35.00,DR,10550.63,
,,IMPS/P2A/922813570251/MrRANJIT/STATEBAN/MOBUA0,,,,,ZAMROODPUR
16-08-2019,16-08-2019,,,5914.00,CR,16464.63,
,,19,,,,,DEL DL
16-08-2019,16-08-2019,By Clg 000076 240 DELHI,76,9550.00,CR,26014.63,CCGO NORTH MH
18-08-2019,18-08-2019,POS/PATANJALI./NEW DELHI/180819/18:21,,100.00,DR,25914.63,
20-08-2019,20-08-2019,ECOM PUR/One97 Communi/Noida/200819/11:14,,130.00,DR,25784.63,
20-08-2019,20-08-2019,ECOM PUR/One97 Communi/Noida/200819/11:17,,100.00,DR,25684.63,
20-08-2019,20-08-2019,NEFT/MB/AXMB192320846685/MUNEETA,,10000.00,DR,15684.63,
22-08-2019,22-08-2019,REFUND/Revv self drive car /15-AUG-19,,5348.00,CR,21032.63,ATM
,,,,,,,RECONCILATION
22-08-2019,22-08-2019,ECOM PUR/PTM*PAYTM/NOIDA/220819/17:44,,2260.00,DR,18772.63,
22-08-2019,22-08-2019,By Clg 000361 485 DELHI,361,10000.00,CR,28772.63,CCGO NORTH MH
22-08-2019,22-08-2019,IMPS/P2A/923420041048/SATISH/PUNJABN/X010078/,,5305.90,DR,23466.73,
23-08-2019,23-08-2019,EDC/00071-00071-/M037011032984700,,34379.32,CR,57846.05,RECONCILATION
23-08-2019,23-08-2019,ECOM PUR/PTM*PAYTM/NOIDA/230819/11:28,,192.00,DR,57654.05,
23-08-2019,23-08-2019,ECOM PUR/PTM*PAYTM/NOIDA/230819/11:31,,100.00,DR,57554.05,
23-08-2019,23-08-2019,ECOM PUR/PTM*PAYTM/NOIDA/230819/11:32,,50.00,DR,57504.05,
25-08-2019,25-08-2019,ECOM PUR/One97 Communi/Noida/250819/19:04,,250.00,DR,57254.05,
25-08-2019,25-08-2019,ECOM PUR/One97 Communi/Noida/250819/19:06,,240.00,DR,57014.05,
25-08-2019,25-08-2019,POS/REL RETAIL LTD-FR/NEW DELHI/250819/19:30,,246.00,DR,56768.05,
26-08-2019,26-08-2019,EDC/00072-00072-/M037011032984700,,1834.82,CR,58602.87,RECONCILATION
26-08-2019,26-08-2019,NEFT/MB/AXMB192382204340/VINAY SINGH,,500.00,DR,58102.87,
26-08-2019,26-08-2019,NEFT/MB/AXMB192382222516/RANJIT DUTTA,,13000.00,DR,45102.87,
26-08-2019,26-08-2019,NEFT/MB/AXMB192382345982/RANJIT DUTTA,,20200.00,DR,24902.87,
28-08-2019,28-08-2019,ECOM PUR/One97 Communi/Noida/280819/19:19,,100.00,DR,24802.87,
02-09-2019,02-09-2019,ECOM PUR/One97 Communi/Noida/020919/12:40,,1167.30,DR,23635.57,
02-09-2019,02-09-2019,ECOM PUR/PTM*PAYTM/NOIDA/020919/12:51,,500.00,DR,23135.57,
02-09-2019,02-09-2019,ECOM PUR/ONE97 COMMUNI/NOIDA/020919/13:23,,175.00,DR,22960.57,
02-09-2019,02-09-2019,POS/RELIANCE ./NEW DELHI/020919/13:39,,406.32,DR,22554.25,
02-09-2019,02-09-2019,UPI/P2A/924538827024/RANJIT DU/Paytm Pay/NA,,400.00,CR,22954.25,
02-09-2019,02-09-2019,IMPS/P2A/924516300240/AbhiWa/VIJAYAB/X000015/,,2205.90,DR,20748.35,
03-09-2019,03-09-2019,NEFT/MB/AXMB192465052091/RANJIT DUTTA,,9000.00,DR,11748.35,
04-09-2019,04-09-2019,IMPS/P2A/924715204286/SATISH/PUNJABN/X010078/,,2905.90,DR,8842.45,
04-09-2019,04-09-2019,ATM-CASH/+132 QUTUB ROAD SA/DELHI/040919,,1000.00,DR,7842.45,
04-09-2019,04-09-2019,POS/BPCL BCC AUTO PVT/DELHI/040919/16:31,,314.06,DR,7528.39,
14-09-2019,14-09-2019,GST @18% on Charge,,27.00,DR,17656.99,
14-09-2019,14-09-2019,Consolidated Charges for A/c,,150.00,DR,17506.99,
16-09-2019,16-09-2019,POS/DR JOLLY/NEW DELHI/160919/12:43,,600.00,DR,16906.99,
18-09-2019,18-09-2019,MOB/SELFFT/RANJIT DUTTA/918010003842859,,3000.00,DR,13906.99,
18-09-2019,18-09-2019,MOB/SELFFT/RANJIT DUTTA/917010082670968,,3000.00,DR,10906.99,
18-09-2019,18-09-2019,ECOM PUR/PTM*IRCTC/NOIDA/180919/11:28,,537.70,DR,10369.29,
18-09-2019,18-09-2019,ECOM PUR/One97 Communi/Noida/180919/12:33,,199.00,DR,10170.29,
22-09-2019,22-09-2019,ECOM PUR/PAYTM/Noida/220919/16:43,,69.00,DR,10101.29,
30-09-2019,30-09-2019,EDC/00078-00078-/M037011032984700,,1907.75,CR,13485.59,RECONCILATION
,,,,,,,BALLABHGARH
01-10-2019,01-10-2019,NEFT/MB/AXMB192743990913/RANJIT DUTTA,,500.00,DR,12985.59,
01-10-2019,01-10-2019,ECOM PUR/One97 Communi/Noida/011019/14:06,,160.00,DR,12825.59,
01-10-2019,01-10-2019,NEFT/MB/AXMB192744247104/SOBAWATI,,8000.00,DR,4825.59,
01-10-2019,01-10-2019,ECOM PUR/PTM*PAYTM/NOIDA/011019/17:01,,1.00,DR,4824.59,
02-10-2019,02-10-2019,ECOM PUR/One97 Communi/Noida/021019/18:35,,137.00,DR,4687.59,
05-10-2019,05-10-2019,EDC/00079-00079-/M037011032984700,,58658.94,CR,63346.53,RECONCILATION
05-10-2019,05-10-2019,IMPS/P2A/927814087383/RANJIT/HDFCBAN/X080290/,,59005.90,DR,4340.63,
05-10-2019,05-10-2019,IMPS/P2A/927816777905/SURABHIA/STANDARD/52,,3600.00,CR,7940.63,
05-10-2019,05-10-2019,POS/PATANJALI./NEW DELHI/051019/19:37,,100.00,DR,7840.63,
12-10-2019,12-10-2019,GST @18% on Charge,,12.60,DR,7828.03,
12-10-2019,12-10-2019,Consolidated Charges for A/c,,70.00,DR,7758.03,
17-10-2019,17-10-2019,BRN-BY CASH RANJIT,,7000.00,CR,14758.03,
18-10-2019,18-10-2019,ECOM PUR/One97 Communi/Noida/181019/17:07,,35.00,DR,14723.03,
,,IMPS/P2A/929214100249/INDUBHAR/HDFCBANK/paymen,,,,,ZAMROODPUR
19-10-2019,19-10-2019,,,2000.00,CR,16723.03,
,,t,,,,,DEL DL
22-10-2019,22-10-2019,ECOM PUR/PTM*PAYTM/NOIDA/221019/13:47,,5970.00,DR,10753.03,
24-10-2019,24-10-2019,Dr Card Charges ANNUAL 5223XXXXXXXX6601,,295.00,DR,10458.03,
24-10-2019,24-10-2019,ECOM PUR/One97 Communi/Noida/241019/20:51,,85.75,DR,10372.28,
28-10-2019,28-10-2019,MOB/SELFFT/RANJIT DUTTA/917010082670968,,3200.00,CR,13572.28,
28-10-2019,28-10-2019,MOB/SELFFT/RANJIT DUTTA/918010003842859,,3000.00,CR,16572.28,
28-10-2019,28-10-2019,IMPS/P2A/930113384128/RANJIT/STATEBA/X035769/,,16005.90,DR,566.38,
02-11-2019,02-11-2019,,,10000.00,CR,10566.38,
,,BNA/DPRH329801/1057/021119/SOUTH D,,,,,DEL DL
05-11-2019,05-11-2019,By Clg 000383 485 DELHI,383,10000.00,CR,20566.38,CCGO NORTH MH
05-11-2019,05-11-2019,POS/ARORA CREATION/NEW DELHI/051119/20:12,,1525.00,DR,19041.38,
07-11-2019,07-11-2019,ECOM PUR/One97 Communi/Noida/071119/20:58,,713.44,DR,18327.94,
08-11-2019,08-11-2019,IMPS/P2A/931208708274/RANJIT/HDFCBAN/X080290/,,12005.90,DR,6322.04,
09-11-2019,09-11-2019,GST @18% on Charge,,189.00,DR,6133.04,
09-11-2019,09-11-2019,Consolidated Charges for A/c,,1050.00,DR,5083.04,
10-11-2019,10-11-2019,ECOM PUR/One97 Communi/Noida/101119/19:04,,334.98,DR,4748.06,
15-11-2019,15-11-2019,IMPS/P2A/931916091620/RANJIT/HDFCBAN/X080290/,,202.95,DR,4545.11,
16-11-2019,16-11-2019,NEFT/N320190983426385/INDU BHARGAVA/Payment,,3300.00,CR,7845.11,RTGS HUB
20-11-2019,20-11-2019,ECOM PUR/One97 Communi/Noida/201119/15:01,,60.00,DR,7785.11,
20-11-2019,20-11-2019,19376685-MMC NOV 2019,,81.42,DR,7703.69,ATM
